vanilla syrup	TOPPING(vanilla_syrup)
vanilla	TOPPING(vanilla_syrup)
caramel syrup	TOPPING(caramel_syrup)
caramel	    TOPPING(caramel_syrup)
cinnamon dolce syrup	TOPPING(cinnamon_dolce_syrup)
cinnamon dolce	TOPPING(cinnamon_dolce_syrup)
cinnamon syrup	TOPPING(cinnamon_dolce_syrup)
hazelnut syrup	TOPPING(hazelnut_syrup)
hazelnut	TOPPING(hazelnut_syrup)
rasberry syrup	TOPPING(raspberry_syrup)
raspberry syrup	TOPPING(raspberry_syrup)
simple syrup	TOPPING(syrup)
syrup	TOPPING(syrup)
plain syrup	TOPPING(syrup)
syrups	TOPPING(syrup)
foam	TOPPING(foam)
cinnamon	TOPPING(cinnamon)
cinamon TOPPING(cinnamon)
cinammon	TOPPING(cinnamon)
whipped cream	TOPPING(whipped_cream)
cream	TOPPING(whipped_cream)
drizzles	TOPPING(drizzles)
drizzle	TOPPING(drizzles)
crumbles	TOPPING(crumbles)
crumble	TOPPING(crumbles)
honey	TOPPING(honey)
four extra shots	TOPPING(ESPRESSO_SHOT_4)
four extra espresso shots	TOPPING(ESPRESSO_SHOT_4)
four extra shots of espresso	TOPPING(ESPRESSO_SHOT_4)
four shots	TOPPING(ESPRESSO_SHOT_4)
four espresso shots	TOPPING(ESPRESSO_SHOT_4)
four shots of espresso	TOPPING(ESPRESSO_SHOT_4)
three extra shots	TOPPING(ESPRESSO_SHOT_3)
three extra espresso shots	TOPPING(ESPRESSO_SHOT_3)
three extra shots of espresso	TOPPING(ESPRESSO_SHOT_3)
three shots	TOPPING(ESPRESSO_SHOT_3)
three espresso shots	TOPPING(ESPRESSO_SHOT_3)
three shots of espresso	TOPPING(ESPRESSO_SHOT_3)
two extra shots	TOPPING(ESPRESSO_SHOT_2)
two extra espresso shots	TOPPING(ESPRESSO_SHOT_2)
two extra shots of espresso	TOPPING(ESPRESSO_SHOT_2)
two shots	TOPPING(ESPRESSO_SHOT_2)
two extra shots	TOPPING(ESPRESSO_SHOT_2)
two espresso shots	TOPPING(ESPRESSO_SHOT_2)
two shots of espresso	TOPPING(ESPRESSO_SHOT_2)
extra shot	TOPPING(ESPRESSO_SHOT_1)
extra espresso shot	TOPPING(ESPRESSO_SHOT_1)
extra expresso shot	TOPPING(ESPRESSO_SHOT_1)
extra shot of espresso	TOPPING(ESPRESSO_SHOT_1)
add espresso	TOPPING(ESPRESSO_SHOT_1)
an extra shot	TOPPING(ESPRESSO_SHOT_1)
an extra shot of espresso	TOPPING(ESPRESSO_SHOT_1)
an extra espresso shot	TOPPING(ESPRESSO_SHOT_1)
one extra shot	TOPPING(ESPRESSO_SHOT_1)
one extra espresso shot	TOPPING(ESPRESSO_SHOT_1)
an espresso shot	TOPPING(ESPRESSO_SHOT_1)
one espresso shot	TOPPING(ESPRESSO_SHOT_1)
one shot of espresso	TOPPING(ESPRESSO_SHOT_1)
a shot of espresso	TOPPING(ESPRESSO_SHOT_1)

